..........
....@.....
##########
##########
##########