


            ######                   #
@          S    # J !  ! !       !    #
##+++++CCCJ###   # ##J##J###JSSS####   #
              #   #                 #   #
                   #                 #   #
                   #                  #   #######
       F+JS++++##S#      #           #           #
     ##                     J#                  F#
                      J#         J################
##J#####S##S###S######